00000000000
B---------0
000000000-0
000000000-0
000000000-0
E---------0
00000000000