00000000000
B----------
0000000000-
0000000000-
0000000000-
E----------
00000000000
