0000000000
00-------B
00-0000000
00-0000000
00-------0
00000000-0
E--------0