00000000000000000000
B------------------0
000000000000000000-0
0000000000---------0
0000000000-000000000
0000000000-000000000
0000000000E000000000